█████████████████████████******************************█████████████████████████
█                       █******************************█                       █
█                       █******************************█                       █
█                       █******************************█                       █
█                       █******************************█                       █
█                       █******************************█                       █
█                       █******************************█                       █
█                       █******************************█                       █
█                       █******************************█                       █
█                       ████████████████████████████████                       █
█                                                                              █
█                                                                              █
█                                                                              █
█                                                                              █
█                                                                              █
█                       ████████████████████████████████                       █
█                       █******************************█                       █
█                       █******************************█                       █
█                       █******************************█                       █
█                       █******************************█                       █
█                       █******************************█                       █
█                       █******************************█                       █
█                       █******************************█                       █
█                       █******************************█                       █
█████████████████████████******************************█████████████████████████